SO ./textures/0.xpm
WE ./textures/1.xpm
EA ./textures/2.xpm
F 160,160,160

NO ./textures/3.xpm

C 100,100,100


        1111111111111111111111111
        1000000000110000000000001
        1000000000110000000000001
        1000000000110000000000001
        1011000001110000000000001
        1011000001110000000000011
        100100000000000000000001
        1001000000W0000000000001
11111111100100000000000000000001
10000000000100000100011111111111
11100111111110001100000010001
11100111111111001100000010001
11000000110001001100000000001
10000000000000001000000000001
10000000000000001101010010001
11000001110101011101011010001
11110111 1110101 101111010001
11111111 1111111 111111111111