SO ./textures/0.xpm
WE ./textures/1.xpm
EA ./textures/2.xpm

NO ./textures/3.xpm

F 154,50,65
C 58,50,65


   1111111111111111111
   1000000100000000001
   1000000100000001001
   1111100000000001111
1111  1000000000001
1001  1000000000001
1001  1000101111111
1001111000101
1000010000101
1111000000111
   110000011111111111
   1000000100000000001
   1000000000000001001
   111110000000000111
1111001000000000001
1000001000000000001
1001111000001111111
1000000000N01
1000000000001
1111111111111