SO ./textures/a.xpm
WE ./textures/b.xpm
EA ./textures/c.xpm

NO ./textures/d.xpm


F 154,50,65
C 58,50,65

11111111111111111111111111111111
10000000001000000111111110000001
10000000101011101000000010000001
10000000101010101011111010000001
10000000101000101010001010000001
10000000101000101010101010000001
10000000101000101010101010000001
10000000101000101000001010000001
10000000101000101000001010000001
10000000101000101111111010000001
10000000101000100000000010000001
10000000101000111111111110000001
10000000101000000000000000000001
10000000000000000000000000000001
11111111111111111111111111111111
